##### ##### ###### #
        1           #
#   #        #   . #
#              R   #
#    ########      #
#        R         #
#   #   *    #     #
#           R      #
########### ###### #