########### ###### #
        1           #
#   #        #   . #
#                  #
#    ########      #
#                  #
#   #   *    #     #
#                  #
########### ###### #