####################
#                 #
#   #        #    #
#                 #
#    ########     #
#                 #
#   #        #    #
#                 #
####################