########### ########
        1          #
#   #        #     #
#                  #
#    ########      #
#                  #
#   #        #     #
#
########### ########